1111111111111
1101000000011
1111100000011
1P0000E00C001
1111111111111