1111111111111
1101000000011
1111111111111
1P0000C00E001
1111111111111