111111111111111111111111111111111
100010000111101110000101110100001
101110110111101110110100110101111
100010110111101110110101010101001
111010110111101110110101100101101
100010000100100010000101110100001
111111111111111111111111111111111