11111
10001
10001
10001
10001
1C001
100E1
10001
100C1
10001
100C1
10C01
100C1
10001
10001
10001
10001
10CC1
11P01
10001
10001
10001
11111
