11111111111111111111111111111111111
10000C1C0000CC111100C001001111100C1
1011111011111110000000111000C000011
1P010100000010001110001111101110011
1101000000000C0100111001000C0000001
1000000001C000000111110010001111111
10011011001110100000100010000100011
100011100000001CC0001000C00000010C1
1C0001C0100000100C10001110000111111
11110111101110000111100000000001111
10000000001100000000000000001100011
10111011101101111111011110111111011
10E000001111000C1111C111100001C0011
11111111111111111111111111111111111